48 2
111111111111111111111111111111111111111111111111111
100000000010000000001000000001100000000000000000001
100000000000001000000000000001100000000000000000001
100100010000000000000000000000000000000111100000001
100000000000000001000010000000000010000111100000001
101000000010000001000000010000000000000000000000001
100000000000000000001000000000001111100001000000101
100000010000011000000000000000001111100000000000001
101000000000011000010000110000000000000000011000001
100000000000011000000000100000100000000000011000001
100010000100000000000000100000000001111111111000001
100000000000000010000000110000000001100000011000001
100000001100000000000000000000100000000000011000001
100100001100000000100000000000000000000100011000001
111111111111111111111111111111111111111111111111111
