48 2
111111111111111111111111111111111111111111111111111
100000000010000000001000000001000000000000000000001
100001111010000000001000000000000000000010100000001
100000000000000000001100000000000000000000000100001
100000000000000000000000000000000001000100000010001
100000000000000000000111110000000000000000000000001
100000000100001000000000000100000010000000000100001
100000000000001000000000000000000000000000000000001
100000010000111000000000000000000000000000000000001
100000000000001000000000111100000000001000000000001
100000001000001000000000000000000000000100000010001
100000000000001000000000000000000000000000000010001
100000000000111110000000100000000100000000000010001
100000000000000000000000000000000000000000000010001
111111111111111111111111111111111111111111111111111
