48 2
111111111111111111111111111111111111111111111111111
100000000000000000000000000000000000000000000000001
100000000000000000000000000000000000000000000000001
100000111111111111000000100000011111111111100000001
100000111111111111000000100000011111111111100000001
100000000001100000000000100000011000000001100000001
100000000001100000000000100000011000000001100000001
100000000001100000000000100000011000000001100000001
100000000001100000000000100000011000000001100000001
100000000001100000000000100000011000000001100000001
100000111111111111000000100000011000000001100000001
100000111111111111000000100000011000000001100000001
100000000000000000000000000000000000000000000000001
100000000000000000000000000000000000000000000000001
111111111111111111111111111111111111111111111111111